14
1,5,5,7,7,5,5,4,3,6,3,5,5,6
3,5,6,10,9,5,5,7,14,11,14,3,7,14
11,6,11,14,1,7,6,10,10,10,11,12,8,10
10,9,12,10,3,12,11,14,11,14,10,3,5,14
11,5,6,8,11,7,12,8,10,9,12,9,7,12
11,7,13,7,14,10,1,5,13,5,4,3,13,6
8,9,5,14,9,12,3,7,6,3,6,11,6,10
3,5,5,14,3,6,9,12,11,12,10,10,10,10
10,3,5,13,14,10,3,5,13,6,10,8,9,14
9,14,3,6,11,14,9,5,6,10,10,3,6,10
3,13,14,11,14,11,4,3,13,15,13,14,10,10
10,3,15,12,9,12,3,13,5,14,3,12,10,10
11,12,10,3,5,6,10,1,5,15,13,7,12,10
9,5,13,13,5,13,13,5,5,12,1,12,1,12